11111111111111111111111111
1P000000000000000000000001
10000000000000000000000001
100000000000000I0000000C01
10000000000000000000000001
10000000000000000000000001
10000000000000000000000001
10000000000000000000000001
10000000000000000000000001
10000000000000000000000001
10000000000000000000000001
10000000000000000000000001
100000000000000000000000E1
11111111111111111111111111