11111111111111111111111111
111111C0000T11T00000D000C1
111100C11110TT011100000001
1TT00000000C0C0C00000001C1
1C1111111111111111000001T1
11111100M111111111000C11T1
1111100001111100000C0111C1
1P00C000000C000000000111E1
11111111111111111111111111