111111111111111111111
11111100C0000000000C1
111P11000000000011001
110011000011110010001
110110001110011110101
1100000000000000000E1
111111111111111111111
