111111111111
1P11C0C0C111
1C1100M00111
1C1100000111
1C1111011111
1T1000T00001
100000000001
1001111111T1
1000CE1C0TT1
111111111111