11111111111111111111111111
111111C000C0111C00000000C1
111100C111101111110D010001
1TTTTTTTTT00TTTTTT000101C1
1C1111111111111111000001T1
11111100M111111111000C11T1
1111100001111100000C0111C1
1P00C000000C000000000111E1
11111111111111111111111111