111111111111111111111111
1111111111111111C00000C1
1CTT0DTT0C0TT0TT00000001
1CTT00TT0C0TT0TT00C00001
1111111111111111110011T1
1CT00000C000111111CC11T1
1TM0TT00M000111111CC1101
10C0000000TT1111110011T1
1111111111TT1111110011C1
1P0CC0T0TT000000000011E1
111111111111111111111111
