1111111111111111
1111C0T0C0000001
1P11111111C000T1
1011C00CC11001C1
1T110011111TT1C1
1T110001111001C1
1000000C00C001E1
1111111111111111