11111111111111111111111111
111111C000C0111MC0000000C1
111100C1D11011111100010001
1000TTTTT00000TTTT000101C1
1C1111111111111111000001T1
11111100M111111111TTTC11T1
111110C111111100000C0111C1
1P00C000TT0C000000000111E1
11111111111111111111111111