111111
100001
100001
100P01
111111
