111111111
1C0000001
100P01C01
100001C01
1C0000001
111111111
