111111111
100000001
100P01C01
100001001
100000001
111111111
