111111111
100000001
100P01001
100001001
100000001
111111111
