111111111
100000001
100P01C01
100001C01
100000001
111111111
