111111111111
1C00000000E1
100P01C00001
100001C00001
1C0000000001
111111111111
