111111
1CC001
1000001
100001
1E00P1
111111
