11111111
10000001
100P11C1
1CC11111
10000001
100000E1
11111111
