1111111111110
1000000000001
100000000C001
100001110C001
1000000111000
1EP0000000001
1111000111111
