11111111
1P0000C1
10000EE1
11111111