11111111
10000001
10P110E1
11111111