111111111
1000CC001
100000001
100E000C1
111111111