111111111
1000000P1
100000111
10000C1E1
111111111