11111111111
1E0000000P1
10000000111
1000000C1C1
11111111111