11111111
11E00001
10000111
1CC001P1
11111111